6 7 1
2 2 2 2 2 2 2
2 0 0 0 0 0 0
2 0 S 0 0 0 1
2 0 0 0 0 0 0
2 0 0 0 0 2 0
2 2 2 2 2 2 2