15 30 9
2 2 2 2 2 2 2 2 2 2 2 2 2 2 2 2 2 2 2 2 2 2 2 2 2 2 2 2 2 2 
2 0 0 0 0 0 0 2 0 0 0 0 0 0 0 0 0 2 0 0 1 0 0 2 0 0 0 0 0 2 
2 0 S 0 0 0 0 2 0 S 0 0 0 0 0 0 0 1 0 0 1 0 0 0 0 0 0 S 0 2 
2 0 0 0 0 0 0 2 0 0 0 0 0 0 0 0 0 1 0 0 2 0 0 0 0 0 0 0 0 2 
2 2 1 2 2 0 0 2 2 2 2 0 0 2 2 2 2 2 0 0 2 2 2 2 2 2 2 0 0 2 
2 0 0 0 0 0 0 0 0 0 0 0 0 0 0 0 0 1 0 0 0 0 0 0 0 0 1 0 0 2 
2 0 0 0 0 0 0 0 0 0 0 0 0 0 0 0 0 2 0 0 0 0 0 0 0 0 2 0 0 2 
2 0 0 2 2 2 2 2 2 2 2 0 0 2 2 0 0 2 0 0 2 2 2 2 0 0 2 0 0 2 
2 0 0 0 0 0 0 0 0 0 2 0 0 0 0 0 0 2 0 0 2 0 0 0 0 0 2 0 0 2 
2 0 0 0 0 0 0 0 0 0 1 0 0 0 S 0 0 1 0 0 1 0 0 S 0 0 1 0 0 2 
2 2 2 2 2 1 1 2 0 0 2 2 0 0 0 0 2 2 0 0 2 0 0 0 0 2 2 0 0 2 
2 0 0 0 0 0 0 2 0 0 0 2 2 1 1 2 2 0 0 0 2 0 0 2 2 2 0 0 0 2 
2 0 S 0 0 0 0 2 0 S 0 0 0 0 0 0 0 0 S 0 1 0 0 0 0 0 0 S 0 2 
2 0 0 0 0 0 0 2 0 0 0 0 0 0 0 0 0 0 0 0 2 0 0 0 0 0 0 0 0 2 
2 2 2 2 2 2 2 2 2 2 2 2 2 2 2 2 2 2 2 2 2 2 2 2 2 2 2 2 2 2 
