21 31 22
2 1 1 1 1 1 1 2 1 1 1 1 2 1 1 1 1 1 2 1 1 1 1 2 1 1 1 1 1 1 2 
1 0 0 0 0 0 0 1 0 0 0 0 1 0 0 0 0 0 1 0 0 0 0 1 0 0 0 0 0 0 1 
1 0 S 0 0 0 0 1 0 0 S 0 1 0 0 S 0 0 1 0 0 S 0 1 0 0 0 0 S 0 1 
1 0 0 0 0 0 0 1 0 0 0 0 1 0 0 0 0 0 1 0 0 0 0 1 0 0 0 0 0 0 1 
1 0 0 0 S 0 1 2 1 0 0 1 2 1 1 1 1 1 2 1 0 0 1 2 1 0 S 0 0 0 1 
1 0 0 0 0 0 1 2 1 0 0 1 2 1 1 1 1 1 2 1 0 0 1 2 1 0 0 0 0 0 1 
1 0 0 0 1 1 1 2 1 0 0 1 2 1 0 0 0 1 2 1 0 0 1 2 1 1 1 0 0 0 1 
2 1 1 1 2 2 2 2 1 0 0 1 2 1 0 S 0 1 2 1 0 0 1 2 2 2 2 1 1 1 2 
1 0 0 0 1 1 1 1 1 0 0 1 1 1 0 0 0 1 1 1 0 0 1 1 1 1 1 0 0 0 1 
1 0 0 0 0 1 0 0 0 1 1 0 0 0 1 1 1 0 0 0 1 1 0 0 0 1 0 0 0 0 1 
1 0 S 0 0 1 0 S 0 1 1 0 S 0 1 2 1 0 S 0 1 1 0 S 0 1 0 0 S 0 1 
1 0 0 0 0 1 0 0 0 1 1 0 0 0 1 1 1 0 0 0 1 1 0 0 0 1 0 0 0 0 1 
1 0 0 0 1 1 1 1 1 0 0 1 1 1 0 0 0 1 1 1 0 0 1 1 1 1 1 0 0 0 1 
2 1 1 1 2 2 2 2 1 0 0 1 2 1 0 S 0 1 2 1 0 0 1 2 2 2 2 1 1 1 2 
1 0 0 0 1 1 1 2 1 0 0 1 2 1 0 0 0 1 2 1 0 0 1 2 1 1 1 0 0 0 1 
1 0 0 0 0 0 1 2 1 0 0 1 2 1 1 1 1 1 2 1 0 0 1 2 1 0 0 0 0 0 1 
1 0 0 0 S 0 1 2 1 0 0 1 2 1 1 1 1 1 2 1 0 0 1 2 1 0 S 0 0 0 1 
1 0 0 0 0 0 0 1 0 0 0 0 1 0 0 0 0 0 1 0 0 0 0 1 0 0 0 0 0 0 1 
1 0 S 0 0 0 0 1 0 0 S 0 1 0 0 S 0 0 1 0 0 S 0 1 0 0 0 0 S 0 1 
1 0 0 0 0 0 0 1 0 0 0 0 1 0 0 0 0 0 1 0 0 0 0 1 0 0 0 0 0 0 1 
2 1 1 1 1 1 1 2 1 1 1 1 2 1 1 1 1 1 2 1 1 1 1 2 1 1 1 1 1 1 2 
