19 20 4
2 2 2 2 2 2 2 2 2 2 2 2 2 2 2 2 2 2 2 2 
2 0 0 0 0 0 0 1 0 0 0 0 0 1 0 0 0 0 0 2 
2 0 S 0 0 0 1 1 1 0 0 0 1 1 1 0 0 S 0 2 
2 0 0 0 0 0 0 1 0 0 0 0 0 1 0 0 0 0 0 2 
2 0 0 0 0 2 0 0 0 0 2 0 0 0 0 2 0 0 0 2 
2 0 0 0 2 2 2 0 0 2 2 2 0 0 2 2 2 0 0 2 
2 0 0 0 0 2 0 0 0 0 2 0 0 0 0 2 0 0 0 2 
2 0 0 0 0 0 0 0 0 0 0 0 0 0 0 0 0 0 0 2 
2 3 0 3 0 3 0 3 0 3 0 3 0 3 0 3 0 3 0 2 
2 0 3 0 3 0 3 0 3 0 3 0 3 0 3 0 3 0 3 2 
2 0 0 0 0 0 0 0 0 0 0 0 0 0 0 0 0 0 0 2 
2 0 0 0 0 0 0 0 0 0 0 0 0 0 0 0 0 0 0 2 
2 0 0 0 2 0 0 0 0 2 0 0 0 0 2 0 0 0 0 2 
2 0 0 2 2 2 0 0 2 2 2 0 0 2 2 2 0 0 0 2 
2 0 0 0 2 0 0 0 0 2 0 0 0 0 2 0 0 0 0 2 
2 0 0 0 0 0 1 0 0 0 0 0 1 0 0 0 0 0 0 2 
2 0 S 0 0 1 1 1 0 0 0 1 1 1 0 0 0 S 0 2 
2 0 0 0 0 0 1 0 0 0 0 0 1 0 0 0 0 0 0 2 
2 2 2 2 2 2 2 2 2 2 2 2 2 2 2 2 2 2 2 2 
